                               
  0────────────────────────── 6
  │                           │
  │                           │
  │                           │
  │                           │
  1──────────── 2──────────── 5
  │             │             │
  │             │             │
  │             │             │
  │             │             │
  │             │             │
  4──────────── 3─────────────┘
  │             │              
  │             │              
  │             │              
  │             │              
  └───── 7──────┘              
